Привіт Світе (Hello World)|Hello World
Значення (Values)|Values
Змінні (Variables)|Variables
Константи (Constants)|Constants
Цикли (For)|For
Оператори Розгалуження - Якщо/Інакше (If/Else)|If/Else
Оператори Розгалуження - Перемикач (Switch)|Switch
Масиви (Arrays)|Arrays
Зрізи (Slices)|Slices
Мапи (Maps)|Maps
Діапазон (Range)|Range
Функції (Functions)|Functions
Поверненння Кількох Значень (Multiple Return Values)|Multiple Return Values
Варіативні Функції (Variadic Functions)|Variadic Functions
Замикання (Closures)|Closures
Рекурсія (Recursion)|Recursion
Вказівники (Pointers)|Pointers
Структури (Structs)|Structs
Методи (Methods)|Methods
Інтерфейси (Interfaces)|Interfaces
Помилки (Errors)|Errors
Горутини (Goroutines)|Goroutines
Канали (Channels)|Channels
Буферизація каналiв (Channel Buffering)|Channel Buffering
Синхронізація каналу|Channel Synchronization
Напрямки каналу|Channel Directions
Select
Тайм-аути (Timeouts)|Timeouts
Не Блокуючі Операції на Каналах|Non-Blocking Channel Operations
Закриття каналів|Closing Channels
Діапазон (Range) з Каналами|Range over Channels
Хронометри (Timers)|Timers
Маятники (Tickers)|Tickers
Worker Pools
Обмеження Частоти Запитів|Rate Limiting
Атомарні Лічильники|Atomic Counters
Mutexes
Stateful Goroutines
Сортування|Sorting
Сортування функціями|Sorting by Functions
Паніка|Panic
Відкладення|Defer
Відновлення|Recover
Функцій для роботи з колекціями|Collection Functions
Рядкові Функції|String Functions
Форматування Рядків|String Formatting
Регулярні вирази|Regular Expressions
JSON
XML
Час|Time
Epoch
Форматування Часу|Time Formatting / Parsing
Генерація випадкових чисел|Random Numbers
Конвертація Тексту в Числа|Number Parsing
URL Parsing
SHA1 Хеші|SHA1 Hashes
Кодування Base64|Base64 Encoding
Читання файлів|Reading Files
Запис файлів|Writing Files
Рядкові Фільтри|Line Filters
File Paths
Директорії|Directories
Temporary Files and Directories
Командний Рядок - Аргументи|Command-Line Arguments
Командний Рядок - Прапорці|Command-Line Flags
Command-Line Subcommands
Змінні середовища|Environment Variables
HTTP Клієнти|HTTP Clients
HTTP Сервери|HTTP Servers
Запуск сторонніх процесів|Spawning Processes
Заміна поточного процесу новим|Exec'ing Processes
Сигнали|Signals
Exit
